10 10 10 10 10 10 10 10 10 10 10 10 10 10 10 10 10 10 10 10 10 03 00 04 10 10 10 10 10 10 10 10 10 10 10 10  
10 10 10 10 10 10 10 10 10 10 10 10 10 10 10 10 10 10 10 10 10 03 00 08 01 01 01 01 01 01 01 01 01 01 01 01 
10 10 10 10 10 10 10 10 10 10 10 10 10 10 10 10 10 10 10 10 10 03 00 00 00 00 00 00 00 00 00 00 00 00 00 00
10 10 10 10 10 10 10 10 10 10 10 10 10 10 10 10 10 10 10 10 10 03 00 06 02 02 02 02 02 02 02 02 02 02 02 02 
01 01 01 01 01 01 01 01 01 01 01 01 01 01 01 01 01 01 01 01 01 07 00 04 10 10 10 10 10 10 10 10 10 10 10 10 
00 00 00 00 00 00 00 00 00 00 00 00 00 00 00 00 00 00 00 00 00 00 00 04 10 10 10 10 10 10 10 10 10 10 10 10 
02 05 00 06 02 02 02 02 02 02 02 02 02 02 02 02 02 02 02 02 02 02 02 -2 10 10 10 10 10 10 10 10 10 10 10 10 
10 03 00 04 10 10 10 10 10 10 10 10 10 10 10 10 10 10 10 10 10 10 10 10 10 10 10 10 10 10 10 10 10 10 10 10 
10 03 00 04 10 10 10 10 10 10 10 10 10 10 10 10 10 10 10 10 10 10 10 10 10 10 10 10 10 10 10 10 10 10 10 10 
10 03 00 04 10 10 10 10 10 10 10 10 10 10 10 10 10 10 10 10 10 10 10 10 10 10 10 10 10 10 10 10 10 10 10 10 
10 03 00 08 01 -4 10 -3 01 01 01 01 01 01 01 01 01 01 01 01 01 01 01 01 01 01 -4 10 10 10 10 10 10 10 10 10 
10 03 00 00 00 04 10 03 00 00 00 00 00 00 00 00 00 00 00 00 00 00 00 00 00 00 04 10 10 10 10 10 10 10 10 10
10 -1 02 05 00 04 10 03 00 06 02 02 02 02 02 02 02 02 02 02 02 02 02 02 05 00 04 11 11 11 11 11 10 10 10 10
10 10 10 03 00 04 10 03 00 04 10 10 10 10 10 10 10 10 10 10 10 10 10 10 03 00 04 11 11 11 11 11 10 10 10 10
10 10 10 03 00 04 10 03 00 04 10 10 10 10 10 10 10 10 10 10 10 10 10 10 03 00 04 11 11 11 11 11 10 10 10 10
10 10 10 03 00 08 01 07 00 04 10 10 10 10 10 10 10 10 10 -3 01 01 01 01 07 00 04 10 10 10 10 10 10 10 10 10
10 10 10 03 00 00 00 00 00 04 10 10 10 10 10 10 10 10 10 03 00 00 00 00 00 00 04 10 10 10 10 10 10 10 10 10
10 10 10 -1 02 02 02 02 02 -2 10 10 10 10 10 10 10 10 10 03 00 06 02 02 02 02 -2 10 10 10 10 10 10 10 10 10
10 10 10 10 10 10 10 10 10 10 10 10 10 10 10 -3 01 01 01 07 00 04 10 10 10 10 10 10 10 10 10 10 10 10 10 10 	
10 10 10 10 10 10 10 10 10 10 10 10 10 10 10 03 00 00 00 00 00 04 10 10 10 10 10 10 10 10 10 10 10 10 10 10 	
10 10 10 10 10 10 10 10 10 10 10 10 10 10 10 03 00 06 02 02 02 -2 10 10 10 10 10 10 10 10 10 10 10 10 10 10 	
10 10 10 10 10 10 10 10 10 10 10 10 10 10 10 03 00 04 10 10 10 10 10 10 10 10 10 10 10 10 10 10 10 10 10 10 
10 10 10 10 10 10 10 10 10 10 10 10 10 10 10 03 00 04 10 10 10 10 10 10 10 10 10 10 10 10 10 10 10 10 10 10 

